"filename", "language", "Python", "comment", "blank", "total"
"d:\LIFE\Graph\MELP\melp\MELP.py", "Python", 17, 0, 4, 21
"d:\LIFE\Graph\MELP\melp\__init__.py", "Python", 0, 0, 1, 1
"d:\LIFE\Graph\MELP\melp\data.py", "Python", 21, 0, 10, 31
"d:\LIFE\Graph\MELP\melp\func.py", "Python", 9, 0, 2, 11
"d:\LIFE\Graph\MELP\melp\kernel.py", "Python", 83, 5, 18, 106
"d:\LIFE\Graph\MELP\melp\lib.py", "Python", 15, 0, 5, 20
"d:\LIFE\Graph\MELP\melp\particleSystem.py", "Python", 96, 12, 27, 135
"d:\LIFE\Graph\MELP\melp\render.py", "Python", 97, 0, 6, 103
"d:\LIFE\Graph\MELP\test_melp.py", "Python", 3, 0, 1, 4
"Total", "-", 341, 17, 74, 432